111111111111111111111111111111
100000P000000000000C0000000E11
111111111111111111111111111111