111111111111111111111111111111
100000P0000000E00C000000C00011
111111111111111111111111111111