111111111111111111111111111111
100000P00000C00000000000E01101
111111111111111111111111111111