111111111111111111111111111111
100000000000000000011111001101
100000000111111111110001110001
100111111111111111111101111111
101101111111111110000000000001
100000000000000000000000000001
101111100000000000000000000111
100000000000000000000000001111
100000000000000001111111111111
10111111111110C000000000000001
101110100000001111111111111111
101110101100000000111111111111
101110100000000000000000000111
1P0000111111111111111111111EC1
111111111111111111111111111111