111111111111111111111111111111
1CCCCE000000000000011111C01101
11111000000P000000011111001101
100000000000000000000000000111
100000000P00000000011111001101
10000000000000C000011111000111
111111111111111111111111111111