111111111111111111111111111111
1E0000000000000000011111001101
100000000111111111110001110001
100111111111111111111101111111
101101111111111110000000000001
100000000000000000000000000001
101111100000000000000000000111
100000000000000000000000001111
000000000000000011111111111111
10111111111110C000000000000001
101110100000001111111111111111
101110101100000000111111111111
111110100000000000000000001111
1P1000111111111111111110000C01
111111111111111111111111111111