111111111111111111111111111111
100000P00000000000000000000C11
10000000000000000000000000E011
111111111111111111111111111111