111111111111111111111111111111
100000000000000000011111001101
100000000000PEC000011111001101
100000000000000000011111001101
100000000000000000011111001101
111111111111111111111111111111
111111111111111111111111111111
111111111111111111111111111111
111111111111111111111111111111