111111111111111111111111111111
100000000000000000011111001101
100000000000000C00001111100111
100000000000000000011111001101
100000000000000000011111001101
111111111111111111111111111111
111111111111111111111111111111
11EP11111111111111111111111111
111111111111111111111111111111