111111111111111111111111111111
1E0000000000000000011111C01101
100000000000000000011111001101
100011111111000000000000000111
111110000000011100011111001101
1000000000111000000111110P1101
111111111111111111111111111111