111111111111111111111111111111
100000000000000000011111001101
100000000000P00000011111001101
100000000000000000011111001101
100000000000000000011111001101
100000000000000000011111001101
100000000000000000011111001101
1000E000000000C000011111001101
100000000000000000011111001101
100000000000000000011111001101
100000000000000000011111001101
100000000000000000011111001101
100000000000000000011111001101
100000000000000000011111001101
111111111111111111111111111111