111111111111111111111111111111
100000000000000000011111C01101
11111000000P000000011111001101
100000000000000000000000000111
100000000000000000011111001101
1000000000000C0000111110001111
111011111111E11111111111111111
111011111111111111111111111111
111011111111111111111111111111
11100000000C111111111111111111
111111111111111111111111111111
111111111111111111111111111111
111111111111111111111111111111